WWWWWWWWWWWWWWWWW
W---W----t-----tW
W-p-------------W
W---W-t-----t---W
WWWWWWWWWWWWWWWWW