WWWWWWWWWWWWWWWWW
W---W----t-----tW
W-p-------------W
W---W-t-----t---W
WWWWWWW-WWWWWWWWW
W--------W------W
Wt--tW---W------W
W----W-t-W------W
WWWWWWWWWWWWWWWWW