WWWWWWWWWWWWWWWWWWWWWW
W---W----t-----t-----W
W-p------------------W
W---W-t-----t--------W
WWWWWWWWWWWWWWWWWWWWWW