WWWWWWWWWWWWWWWWW
W---W-----------W
W-p-------------W
W---W-t---------W
WWWWWWWWWWWWWWWWW